WWWWWWWWWWWWWWWWWWWWWWWWWWWW
WCCCCCCCCCCCCWWCCCCCCCCCCCCW
WCWWWWCWWWWWCWWCWWWWWCWWWWCW
WCWWWWCWWWWWCWWCWWWWWCWWWWCW
WCWWWWCWWWWWCWWCWWWWWCWWWWCW
WCCCCCSCCCCCCCCCCCCCCSCCCCCW
WCWWWWCWWCWWWWWWWWCWWCWWWWCW
WCWWWWCWWCWWWWWWWWCWWCWWWWCW
WCCCCCCWWCCCCWWCCCCWWCCCCCCW
WWWWWWCWWWWWCWWCWWWWWCWWWWWW
WWWWWWCWWWWWCWWCWWWWWCWWWWWW
WWWWWWCWWCCCCCCCCCCWWCWWWWWW
WWWWWWCWWCWWWEEWWWCWWCWWWWWW
WWWWWWCWWCW100004WCWWCWWWWWW
WWWWWWCCCCW000000WCCCCWWWWWW
WWWWWWCWWCW200003WCWWCWWWWWW
WWWWWWCWWCWWWWWWWWCWWCWWWWWW
WWWWWWCWWCCCCCCCCCCWWCWWWWWW
WWWWWWCWWCWWWWWWWWCWWCWWWWWW
WWWWWWCWWCWWWWWWWWCWWCWWWWWW
WCCCCCCCCCCCSWWSCCCCCCCCCCCW
WCWWWWCWWWWWCWWCWWWWWCWWWWCW
WCWWWWCWWWWWCWWCWWWWWCWWWWCW
WCCCWWCCCCCCCCCCCCCCCCWWCCCW
WWWCWWCWWCWWWWWWWWCWWCWWCWWW
WWWCWWCWWCWWWWWWWWCWWCWWCWWW
WCCCCCCWWCCCCWWCCCCWWCCCCCCW
WCWWWWWWWWWWCWWCWWWWWWWWWWCW
WCWWWWWWWWWWCWWCWWWWWWWWWWCW
WCCCCCCCCCCCCPCCCCCCCCCCCCCW
WWWWWWWWWWWWWWWWWWWWWWWWWWWW
